1111111111111
100100001C111
1000011000C01
1P00110E00011
1111111111111
